Xos^Efs, Xos^Efs, Xos^Efs, Xos, Xos, Xos, Xos^Efs, Xos, Xos, Xos, Xos^Efs, Xos^Efs, Xos^Efs
Xos, Xos^Efs, Iwr, Iwr, Iwr, Iwr, Iwr, Iwr, Iwr, Iwr, Iwr, Xos^Efs, Xos^Efs
Xos, Iwr, Iwr, Iwr, Iwr, Iwr, Iwr, Iwr, Iwr, Iwr, Iwr, Iwr, Xos
Xos, Iwr, Iwr, Iwr, Iwr, Iwr, Iwr, Iwr, Iwr, Iwr, Iwr, Iwr, Xos
Xos, Iwr, Iwr, Iwr, Iwr, Iwr, Ch, Iwr, Iwr, Iwr, Iwr, Iwr, Xos
Xos, Iwr, Iwr, Iwr, Iwr, Iwr, Iwr, Iwr, Iwr, Iwr, Iwr, Iwr, Xos
Xos, Iwr, Iwr, Iwr, Iwr, Iwr, Iwr, Iwr, Iwr, Iwr, Iwr, Iwr, Xos
Xos, Iwr, Iwr, Iwr, Iwr, Iwr, Iwr, Iwr, Iwr, Iwr, Iwr, Iwr, Xos^Efs
Xos, Xos^Efs, Xos, Xos, Xos, Xos, Xos, Xos, Xos, Xos^Efs, Xos, Xos^Efs, Xos
